####################
#                  #
#                  #
#                  #
#                  #
#                  #
#    O             #
#                  #
#                  #
#           Pppp   #
#                  #
#                  #
#                  #
#                  #
#                  #
#                  #
#                  #
#                  #
#                  #
####################
